type octile
height 11.0
width 11.0
map
...........
...........
...........
...........
...........
...........
...........
...........
...........
...........
...........
