type octile
height 24
width 24
map
........................
........................
........................
........................
........................
........................
..@@@@@@@@@@@@@@@@@@@@@.
..@...................@.
..@...................@.
..@...................@.
..@..............@....@.
..@..............@@...@.
..@.....@.............@.
..@...................@.
..@............@......@.
..@...................@.
..@...................@.
..@...................@.
..@@@@@@@@@@@@@@@@@@@@@.
........................
........................
........................
........................
........................
